111111
1P1111
110C11
1C0E11
111111