111111
1P0111
101C11
1E0111
111111