11111111111
10000000001
100P0000001
10000000001
10000E00001
10C00000001
10000000001
100000C0001
10000000001
1000C000001
10000000001
11111111111